NO ./textures/wall1.png
WE ./textures/wall1.png
SO ./textures/wall1.png
EA ./textures/wall1.png
C 155,100,100
F 111,111,111








111111
100001
1E0001
111111
