F 220,220,150


C 5,30,0,,,,,


NO       textures/ael-maaz.png
WE textures/texture3.png
EA textures/wall2.png
SO  textures/wall4.png


111111111111111111111111111111111111111111111111111111111111111
100000000000000000000000000000000000000000000000000000000000001
1100N0000000000000000000000000000000000000000000000000000000001
100000000000000000000000000000000000000000000000000000000000001
100000000000000000000000000000000000000000000000000000000000001
111111111111111111111111111111111111111111111111111111111111111