F 220,0,0


NO       textures/wall1.png
C 5,30,0,,,,,


WE textures/wall3.png
EA textures/wall2.png
SO  textures/wall4.png

          
1 1 1 1 1
1 1 1 1 11
11011111N1
11111 10001
10001 100001
11111 11111