F 220,0,0


NO       textures/wall1.png
C 5,30,255

WE textures/wall2.png
EA textures/wall3.png
SO  textures/images.png


111111111111111111111
1000000000000000000101111111111
100000000000000000011
100000000100000000011
100000000N00000000011
100000000000000000011
111111111111111111111