F   255,255,255
NO ./textures/1.png
SO      ./textures/1.png
EA     ./textures/1.png
C 155,255,255
WE                                             ./textures/wall1.png




111111   1111111111    
1000011110000000001
1N000110000000000001
111001 1111111111111
111111
