NO ./textures/wall1.png
SO ./textures/wall1.png
WE ./textures/wall1.png
EA ./textures/ael-maaz.png
F 110,153,15
C 255,255,255


        1111111111111111111111111
        1000000000000000000000001
        1100000000000000000000001
        1000000000000000000000001
1111111110000000000N0000000000001
100000000000000000000000000001111
10000000000000010000000000001
10000000000000000000000000001
10000000000000000000000000001
10000000000000000000000000001
10000000000000000001010000001
11000001110101011111011110101
11110111011101110101111010001
11111111111111111111111111111
