NO                  ./textures/wall2.png


SO ./textures/wall2.png


C 0,0,0



WE ./textures/wall2.png
EA ./textures/wall2.png
F 110,153,15


        111111111111111111111111
        100000000000000000000001
        1100000000000000000000001
        1000000000000000000000001
11111111100000000000000011111111
1000000000000000000000000000111111E
10000000000000010000000000001
10000000000000000000000000001
10000000000000000000000000001
10000000000000000000000000001
10000000000000000001010000001
11000001110101011111011110101111
11110111 1110111 1011110100010011
11111111 1111111 111111111111111
